FOXA: 21ST CENTRY FOX A CM
FOX: 21ST CENTRY FOX B CM
ATVI: ACTIVISION BLIZZARD
ADBE: ADOBE SYSTEMS INC
AKAM: AKAMAI TECHNOLOGIES
ALXN: ALEXION PHARM INC
ALTR: ALTERA CORP
AMZN: AMAZON.COM INC
AAL: AMERICAN AIRLINES GP
AMGN: AMGEN
ADI: ANALOG DEVICES CMN
AAPL: APPLE INC.
AMAT: APPLIED MATERIALS
ADSK: AUTODESK INC
ADP: AUTOMATIC DATA PROCS
AVGO: AVAGO TECHNOLOGIES L
BIDU: BAIDU, INC.
BBBY: BED BATH & BEYOND
BIIB: BIOGEN IDEC INC
BRCM: BROADCOM CORP
CHRW: C.H. ROBINSON WW
CA: CA INC
CTRX: CATAMARAN CORPORATIO
CELG: CELGENE CORP
CERN: CERNER CORP
CHTR: CHARTER COMMUNICATIO
CHKP: CHECK POINT SOFTWARE
CSCO: CISCO SYSTEMS INC
CTXS: CITRIX SYSTEMS INC
CTSH: COGNIZANT TECH SOL
CMCSK: COMCAST CL A SPCL
CMCSA: COMCAST CORP A
COST: COSTCO WHOLESALE
DTV: DIRECTV
DISCA: DISCOVERY COMM A
DISCK: DISCOVERY COMM INC
DISH: DISH NETWORK CORP
DLTR: DOLLAR TREE INC
EBAY: EBAY INC.
EA: ELECTRONIC ARTS INC
EQIX: EQUINIX, INC.
EXPD: EXPEDITORS INTL
ESRX: EXPRESS SCRIPTS
FB: FACEBOOK INC
FAST: FASTENAL CO
FISV: FISERV, INC.
GRMN: GARMIN LTD
GILD: GILEAD SCIENCES, INC
GOOGL: GOOGLE INC CL A CMN
GOOG: GOOGLE INC CL C CAP
HSIC: HENRY SCHEIN, INC.
ILMN: ILLUMINA, INC.
INTC: INTEL CORP
INTU: INTUIT INC
ISRG: INTUITIVE SURG, INC.
KLAC: K L A-TENCOR CORP
GMCR: KEURIG GREEN MTN CMN
KRFT: KRAFT FOODS GROUP
LRCX: LAM RESEARCH CORP
LBTYA: LIBERTY GLOBAL ORD A
LBTYK: LIBERTY GLOBAL ORD C
QVCA: LIBERTY INTATV SRS A
LMCK: LIBERTY MEDIA C
LMCA: LIBERTY MEDIA SRS A
LVNTA: LIBERTY VNTRS SRS A
LLTC: LINEAR TECHNOLOGY
MAR: MARRIOT INT CL A
MAT: MATTEL INC
MU: MICRON TECHNOLOGY
MSFT: MICROSOFT CORP
MDLZ: MONDELEZ INTL CMN A
MNST: MONSTER BEVERAGE CP
MYL: MYLAN NV ORD SHS
NTAP: NETAPP, INC.
NFLX: NETFLIX, INC.
NVDA: NVIDIA CORPORATION
NXPI: NXP SEMICONDUCTORS
ORLY: O'REILLY AUTOMOTIVE
PCAR: PACCAR INC.
PAYX: PAYCHEX, INC.
QCOM: QUALCOMM INC
REGN: REGENERON PHARMACEUT
ROST: ROSS STORES, INC.
SNDK: SANDISK CORPORATION
SBAC: SBA COMMUNICATIONS
STX: SEAGATE TECHNOLOGY
SIAL: SIGMA ALDRICH CORP
SIRI: SIRIUS XM HOLDING
